level1
#######
#  A  #
#@    #
#o    #
#######